                                                                                                                                            
                                                                                                                                            
                                                                                                                                            
                                                                                                                                            
                              ############################                                                                                  
                             ##                          ##                                                                                 
                            ##                            ##                                                                                
                           ##                              ##                                                                               
                          ##           ######################                                                                               
                         ##           ##                  ##                                                                                
                         #           ##                    ##                                                                               
                         #### ##    ##                      ##                                                                              
                         ######## ###      ######## ##########                                                                              
                          #     ###                 ##      ##                                                                              
                          #                   ###    ## ###  ##                                                                             
                          ##                          ##      ##                                                                            
                           ##                      #   ##      ##                                                                           
                            ##                    ##    #####   #                                                                           
                             #                    ###########   #                                                                           
                             #                                  #                                                                           
                             #                                  #                                                                           
                             #                            #     #                                                                           
                             #                    ##     ##    ##                                                                           
                             #                     ##  ###    ##                                                                            
                             #                      ####     ##                                                                             
                             #                       ##     ##                                                                              
                             #                             ##                                                                               
                             #                            ##                                                                                
                             ##############################                                                                                 
                                                                                                                                            
                                                                                                                                            
                                                                                                                                            
                                                                                                                                            
                                                                                                                                            
                                                                                                                                            
                                                                                                                                            
                                                                                                                                            
                                                                                                                                            
                                                                                                                                            
                                                                                                                                            
                                                                                                                                            
