                                     **********************                                                                                                                            
                                     *                    *                                                                                                                            
                                     *                    *                                                                                                                            
                    ############     *                    *                                                                                                                            
                    #          #     *                    *                                                                                                                            
                    #          #     **********************                                                                                                                            
                    #          #                                                                                                                                                       
                    ###       ##                                                                                                                                                       
                      #       #                                                                                                                                                        
                      #       #                                                                                                                                                        
        ###############      ################                                                                                                                                          
        #             #      #              #                                                                                                                                          
        #             #      #              #                                                                                                                                          
        #             #      #              #                                                                                                                                          
        #             #      #              #                                                                                                                                          
        #             #      #              #                                                                                                                                          
        #             #      #              #          ******                                                                                                                          
        #             #      #              #          *    *                                                                                                                          
        #             #      #              #          *    *                                                                                                                          
        #             #      #              #          *    *                                                                                                                          
        #             #      #              #          *    *                                                                                                                          
        ###############      ################          *    *                                                                                                                          
                      #      #                         *    *                                                                                                                          
                      #      #                         *    *                                                                                                                          
                      #      #                         *    *                                                                                                                          
                      #      #                         *    *                                                                                                                          
    *******           #      #                         *    *                                                                                                                          
    *     *           #      #                         *    *                                                                                                                          
    *     *           #      #                         *    *                                                                                                                          
    *     *       #####      ######                    *    *                                                                                                                          
    *     *       #               #                    *    *                                                                                                                          
    *     *       #               #                    *    *                                                                                                                          
    *     *       #               #                    *    *                                                                                                                          
    *     *       #               #                    *    *                                                                                                                          
    *     *       #               #                    *    *                                                                                                                          
    *     *       #################                    *    *                                                                                                                          
    *     *                                            *    *                                                                                                                          
    *     *                                            *    *                                                                                                                          
    *     **********************************************    *                                                                                                                          
    *                                                       *                                                                                                                          
    *                                                       *                                                                                                                          
    *                                                       *                                                                                                                          
    *********************************************************                                                                                                                          
                                                                                                                                                                                       
                                                                                                                                                                                       
                                                                                                                                                                                       
                                                                                                                                                                                       
                                                                                                                                                                                       
                                                                                                                                                                                       
                                                                                                                                                                                       
                                                                                                                                                                                       
                                                                                                                                                                                       
                                                                                                                                                                                       
                                                                                                                                                                                       
                                                                                                                                                                                       
